########################################
#......................................#
#...............######.................#
#.................##...................#
##########........##..........##########
#.................##...................#
#.................##...................#
#.................##...................#
##########........##..........##########
#.................##...................#
#.................##...................#
#.................##...................#
#.................##...................#
#.................##...................#
#.......#######################........#
#.......#######################........#
#.................##...................#
#.................##...................#
#.................##...................#
#.................##...................#
#.................##...................#
##########........##..........##########
#.................##...................#
#.................##...................#
#.................##...................#
##########........##..........##########
#.................##...................#
#...............######.................#
#......................................#
########################################
