########################################
#......................................#
#......................................#
#......................................#
##########....................##########
#......................................#
#......................................#
#......................................#
##########....................##########
#......................................#
#......................................#
#.................##...................#
#.................##...................#
#.................##...................#
#.................##...................#
#.................##...................#
#.................##...................#
#.................##...................#
#.................##...................#
#......................................#
#......................................#
##########....................##########
#......................................#
#......................................#
#......................................#
##########....................##########
#......................................#
#......................................#
#......................................#
########################################
